/bin/fusermount	root:root	-rwsr-xr-x
/bin/mount	root:root	-rwsr-xr-x
/bin/ntfs-3g	root:root	-rwsr-xr-x
/bin/ping6	root:root	-rwsr-xr-x
/bin/ping	root:root	-rwsr-xr-x
/bin/su	root:root	-rwsr-xr-x
/bin/umount	root:root	-rwsr-xr-x
/sbin/pam_extrausers_chkpwd	root:shadow	-rwxr-sr-x
/sbin/unix_chkpwd	root:shadow	-rwxr-sr-x
/usr/bin/bsd-write	root:tty	-rwxr-sr-x
/usr/bin/chage	root:shadow	-rwxr-sr-x
/usr/bin/chfn	root:root	-rwsr-xr-x
/usr/bin/chsh	root:root	-rwsr-xr-x
/usr/bin/crontab	root:crontab	-rwxr-sr-x
/usr/bin/expiry	root:shadow	-rwxr-sr-x
/usr/bin/gpasswd	root:root	-rwsr-xr-x
/usr/bin/mlocate	root:mlocate	-rwxr-sr-x
/usr/bin/newgrp	root:root	-rwsr-xr-x
/usr/bin/passwd	root:root	-rwsr-xr-x
/usr/bin/pkexec	root:root	-rwsr-xr-x
/usr/bin/ssh-agent	root:ssh	-rwxr-sr-x
/usr/bin/sudo	root:root	-rwsr-xr-x
/usr/bin/wall	root:tty	-rwxr-sr-x
/usr/lib/dbus-1.0/dbus-daemon-launch-helper	root:messagebus	-rwsr-xr--
/usr/lib/eject/dmcrypt-get-device	root:root	-rwsr-xr-x
/usr/lib/evolution/camel-lock-helper-1.2	root:mail	-rwxr-sr-x
/usr/lib/i386-linux-gnu/oxide-qt/chrome-sandbox	root:root	-rwsr-xr-x
/usr/lib/i386-linux-gnu/utempter/utempter	root:utmp	-rwxr-sr-x
/usr/lib/openssh/ssh-keysign	root:root	-rwsr-xr-x
/usr/lib/policykit-1/polkit-agent-helper-1	root:root	-rwsr-xr-x
/usr/lib/snapd/snap-confine	root:root	-rwsr-xr-x
/usr/lib/xorg/Xorg.wrap	root:root	-rwsr-sr-x
/usr/sbin/pppd	root:dip	-rwsr-xr--
